AAAAAAAAAAAAAAAAAAAAAAAAAAAAAAAAAAAAAAAAAAAAAAAAAAAAAAAAAAAAAAAAAAAAAAAAAAAAA
AASEEEEEEEEEEAAEEE#EEEEEEEEEEEEEEEEEEEEEEEEEEEEEEEEEEEEEEEEEEEEEEAEEEEEEAEEEE
AAAAAAAAEEEEEEEEEEEEE#EEEEESEEEEEEEEEEEEEEEEEEE#EEEEEEEEEEEEEEEEAEEEEEEAEEEE
AAEAEEEAEEEEEEEEEEEAAAAHAAAAAAEAAAAAAAAAAAAEEEEEEEEEEEEEEEEEEEEEEAEEEEEEAEEEE
AAAAAAAAEEELEELEEEAEEEEEEEEEEEEEEEEEEEEEEEEEEEAAEEEEEEEAEEEEEEEEEAEEEEEEEAEEEE
AAAAAAAAEEEEEEEEEEEEEEEEEEEEEEEEEEEEEEEEEEEEEEEEEEEEEEEEEEEEEEEEEAEEEEEEEEEEEE
AAAAAAAAEEEEEEEEEEEEEEEEEEEEEEEEEEEEEEEEEEEEEEEEEEEEEEEEEEEEEEEEEAEEEEEEEEEEEE
AAAAAAAAEEEEEEEEEEEEEEEEEEEEEEEEEEEEEEEEEEEEEEEEEEEEEEEEEEEEEEEEEAEEEEEEEEEEEE
AA#AAAAAEEHEAEEEA#AEAEAAAAAAAEEEEEEEESEEEEEEAEEEESEEEEAAEEE#EEAAEAEEEEEEAEEEE
AAWWAAAAAAAAAEEAAAAAAEEAAEEEEEEEAFFFFAAAAAAAAAEEEAAAAAAAAAAAAAAAAAAAAAAAAAAAA
AAAAAATAAAAAAAAAAAAAAEEAAEEEEEEEAAAAAAAAAAAAAAEEEAAAAAAAAAAAAAAAAAAAAAAAAAAAA
AAAAAAAAAAAAAEEAAAAAAAAAAEEEEEEEAAAAAAAAAAAAAATEEAAAAAAAAAAAAAAAAAAAAAAAAAAAA
AAAAAAAAAAAAAAAAAAAAAAAAAAAAAAAAAAAAAAAAAAAAAAAAAAAAAAAAAAAAAAAAAAAAAAAAAAAAA